#####################
###########     ##E##
############ ## ## ##
##########   ##    ##
########## ####### ##
########## ####### ##
#######    #####   ##
####### ######### ###
####### ######### ###
#######           ###
####### ####### #####
####### ####### #####
####### ####### #####
####### ####### #####
####### ####### #####
####### ####### #####
####### ####### #####
####### ####### #####
####### ####### #####
#######S        #####
#####################